111111111111111111111
1000E000000C000P00001
111111111111111111111
