111111111111111111
11100000000001P001
1000000C0000010001
100E000000P0010001
1110000C11000P0001
1000000010000C0001
111111111111111111
