111111111111111111
100000000000000001111111
1000C0000000000000000001
1000E00000000C0000000001
1000000000E0000000000001
1000000000000C0001111111
111111111111111111
