111111111111111111
10000000000000P001
1000000C0000000001
100E000000P0000001
1000000C00000P0001
1000000000000C0001
111111111111111111
