111111111111111111
10000000000000P001
100000000000000001
100E00000000000001
100000000000000001
1000000000000C0001
111111111111111111
