11111111111111111111111
11100000000001000000P11
100000011C1100010000001
1E1100000000000C0000C01
11111111111111111111111
