11111111111111111
10000P00000E00001
11111111111111111
