111111111111111
1000000C000P001
111111111111111
