11111111111111111111
100000C00E0000000001
11111111111111111111
