1111111111111111111
111111000000000011111
1111111111111111111
