111111111111111111
100000000000000001111111
100000000000000000000001
100000000000000000000001
100000000000000000000001
100000000000000001111111
111111111111111111
